FFFFFFFFFFFF
1FTTTFFTTTF1
3FTTTFFTTTF3
4FTTTFFTTTF4
FFFFFFFFFFFF
FPFMMMMMMFPF