GGFFFFFFFFGG
GFTTTFFTTTFG
GFTTTFFTTTFG
GFTTTFFTTTFG
EFFFFFFFFFFE
SPFMMMMMMFPS