1FFFFFFFFFF1
2FTTTFFTTTF2
4FTTTFFTTTF4
5FTTTFFTTTF5
FFFFFFFFFFFF
FPFMMMMMMFPF