21FFFFFFFF21
3FTTTFFTTTF3
4FTTTFFTTTF4
5FTTTFFTTTF5
EFFFFFFFFFFE
FPFMMMMMMFPF