1FFFFFFFFFF1
3FTTTFFTTTF3
4FTTTFFTTTF4
5FTTTFFTTTF5
FFFFFFFFFFFF
FPFMMMMMMFPF