21FFFFFFFF12
3FTTTFFTTTF3
4FTTTFFTTTF4
5FTTTFFTTTF5
EFFFFFFFFFFE
SPFMMMMMMFPS